020201|020201|020201|020201|020201|000000|000000|000000|000000|000000|000000|000000|000000|000000|000000|000000|000000|000000|000000|000000|000000|000000|000000|000000|000000|000000|000000|000000|000000|000000|000000|000000|000000|000000|000000|000000|000000|000000|000000|000000|000000|000000|000000|000000|000000|000000|000000|000000|000000|000000|
020201|000000|000000|000000|020201|000000|000000|000000|000000|000000|000000|000000|000000|000000|000000|000000|000000|000000|000000|000000|000000|000000|000000|000000|000000|000000|000000|000000|000000|000000|000000|000000|000000|000000|000000|000000|000000|000000|000000|000000|000000|000000|000000|000000|000000|000000|000000|000000|000000|000000|
020201|000000|000000|000000|020201|000000|000000|000000|000000|000000|000000|000000|000000|000000|000000|000000|000000|000000|000000|000000|000000|000000|000000|000000|000000|000000|000000|000000|000000|000000|000000|000000|000000|000000|000000|000000|000000|000000|000000|000000|000000|000000|000000|000000|000000|000000|000000|000000|000000|000000|
020201|000000|000000|000000|020201|000000|000000|000000|000000|000000|000000|000000|000000|000000|000000|000000|000000|000000|000000|000000|000000|000000|000000|000000|000000|000000|000000|000000|000000|000000|000000|000000|000000|000000|000000|000000|000000|000000|000000|000000|000000|000000|000000|000000|000000|000000|000000|000000|000000|000000|
020201|020201|020201|020201|020201|000000|000000|000000|000000|000000|000000|000000|000000|000000|000000|000000|000000|000000|000000|000000|000000|000000|000000|000000|000000|000000|000000|000000|000000|000000|000000|000000|000000|000000|000000|000000|000000|000000|000000|000000|000000|000000|000000|000000|000000|000000|000000|000000|000000|000000|
000000|000000|000000|000000|000000|000000|000000|000000|000000|000000|000000|000000|000000|000000|000000|000000|000000|000000|000000|000000|000000|000000|000000|000000|000000|000000|000000|000000|000000|000000|000000|000000|000000|000000|000000|000000|000000|000000|000000|000000|000000|000000|000000|000000|000000|000000|000000|000000|000000|000000|
000000|000000|000000|000000|000000|000000|000000|000000|000000|000000|000000|000000|000000|000000|000000|000000|000000|000000|000000|000000|000000|000000|000000|000000|000000|000000|000000|000000|000000|000000|000000|000000|000000|000000|000000|000000|000000|000000|000000|000000|000000|000000|000000|000000|000000|000000|000000|000000|000000|000000|
000000|000000|000000|000000|000000|000000|000000|000000|000000|000000|000000|000000|000000|000000|000000|000000|000000|000000|000000|000000|000000|000000|000000|000000|000000|000000|000000|000000|000000|000000|000000|000000|000000|000000|000000|000000|000000|000000|000000|000000|000000|000000|000000|000000|000000|000000|000000|000000|000000|000000|
000000|000000|000000|000000|000000|000000|000000|000000|000000|000000|000000|000000|000000|000000|000000|000000|000000|000000|000000|000000|000000|000000|000000|000000|000000|000000|000000|000000|000000|000000|000000|000000|000000|000000|000000|000000|000000|000000|000000|000000|000000|000000|000000|000000|000000|000000|000000|000000|000000|000000|
000000|000000|000000|000000|000000|000000|000000|000000|000000|000000|000000|000000|000000|000000|000000|000000|000000|000000|000000|000000|000000|000000|000000|000000|000000|000000|000000|000000|000000|000000|000000|000000|000000|000000|000000|000000|000000|000000|000000|000000|000000|000000|000000|000000|000000|000000|000000|000000|000000|000000|
000000|000000|000000|000000|000000|000000|000000|000000|000000|000000|000000|000000|000000|000000|000000|000000|000000|000000|000000|000000|000000|000000|000000|000000|000000|000000|000000|000000|000000|000000|000000|000000|000000|000000|000000|000000|000000|000000|000000|000000|000000|000000|000000|000000|000000|000000|000000|000000|000000|000000|
000000|000000|000000|000000|000000|000000|000000|000000|000000|000000|000000|000000|000000|000000|000000|000000|000000|000000|000000|000000|000000|000000|000000|000000|000000|000000|000000|000000|000000|000000|000000|000000|000000|000000|000000|000000|000000|000000|000000|000000|000000|000000|000000|000000|000000|000000|000000|000000|000000|000000|
000000|000000|000000|000000|000000|000000|000000|000000|000000|000000|000000|000000|000000|000000|000000|000000|000000|000000|000000|000000|000000|000000|000000|000000|000000|000000|000000|000000|000000|000000|000000|000000|000000|000000|000000|000000|000000|000000|000000|000000|000000|000000|000000|000000|000000|000000|000000|000000|000000|000000|
000000|000000|000000|000000|000000|000000|000000|000000|000000|000000|000000|000000|000000|000000|000000|000000|000000|000000|000000|000000|000000|000000|000000|000000|000000|000000|000000|000000|000000|000000|000000|000000|000000|000000|000000|000000|000000|000000|000000|000000|000000|000000|000000|000000|000000|000000|000000|000000|000000|000000|
000000|000000|000000|000000|000000|000000|000000|000000|000000|000000|000000|000000|000000|000000|000000|000000|000000|000000|000000|000000|000000|000000|000000|000000|000000|000000|000000|000000|000000|000000|000000|000000|000000|000000|000000|000000|000000|000000|000000|000000|000000|000000|000000|000000|000000|000000|000000|000000|000000|000000|
000000|000000|000000|000000|000000|000000|000000|000000|000000|000000|000000|000000|000000|000000|000000|000000|000000|000000|000000|000000|000000|000000|000000|000000|000000|000000|000000|000000|000000|000000|000000|000000|000000|000000|000000|000000|000000|000000|000000|000000|000000|000000|000000|000000|000000|000000|000000|000000|000000|000000|
000000|000000|000000|000000|000000|000000|000000|000000|000000|000000|000000|000000|000000|000000|000000|000000|000000|000000|000000|000000|000000|000000|000000|000000|000000|000000|000000|000000|000000|000000|000000|000000|000000|000000|000000|000000|000000|000000|000000|000000|000000|000000|000000|000000|000000|000000|000000|000000|000000|000000|
000000|000000|000000|000000|000000|000000|000000|000000|000000|000000|000000|000000|000000|000000|000000|000000|000000|000000|000000|000000|000000|000000|000000|000000|000000|000000|000000|000000|000000|000000|000000|000000|000000|000000|000000|000000|000000|000000|000000|000000|000000|000000|000000|000000|000000|000000|000000|000000|000000|000000|
000000|000000|000000|000000|000000|000000|000000|000000|000000|000000|000000|000000|000000|000000|000000|000000|000000|000000|000000|000000|000000|000000|000000|000000|000000|000000|000000|000000|000000|000000|000000|000000|000000|000000|000000|000000|000000|000000|000000|000000|000000|000000|000000|000000|000000|000000|000000|000000|000000|000000|
000000|000000|000000|000000|000000|000000|000000|000000|000000|000000|000000|000000|000000|000000|000000|000000|000000|000000|000000|000000|000000|000000|000000|000000|000000|000000|000000|000000|000000|000000|000000|000000|000000|000000|000000|000000|000000|000000|000000|000000|000000|000000|000000|000000|000000|000000|000000|000000|000000|000000|
000000|000000|000000|000000|000000|000000|000000|000000|000000|000000|000000|000000|000000|000000|000000|000000|000000|000000|000000|000000|000000|000000|000000|000000|000000|000000|000000|000000|000000|000000|000000|000000|000000|000000|000000|000000|000000|000000|000000|000000|000000|000000|000000|000000|000000|000000|000000|000000|000000|000000|
000000|000000|000000|000000|000000|000000|000000|000000|000000|000000|000000|000000|000000|000000|000000|000000|000000|000000|000000|000000|000000|000000|000000|000000|000000|000000|000000|000000|000000|000000|000000|000000|000000|000000|000000|000000|000000|000000|000000|000000|000000|000000|000000|000000|000000|000000|000000|000000|000000|000000|
000000|000000|000000|000000|000000|000000|000000|000000|000000|000000|000000|000000|000000|000000|000000|000000|000000|000000|000000|000000|000000|000000|000000|000000|000000|000000|000000|000000|000000|000000|000000|000000|000000|000000|000000|000000|000000|000000|000000|000000|000000|000000|000000|000000|000000|000000|000000|000000|000000|000000|
000000|000000|000000|000000|000000|000000|000000|000000|000000|000000|000000|000000|000000|000000|000000|000000|000000|000000|000000|000000|000000|000000|000000|000000|000000|000000|000000|000000|000000|000000|000000|000000|000000|000000|000000|000000|000000|000000|000000|000000|000000|000000|000000|000000|000000|000000|000000|000000|000000|000000|
000000|000000|000000|000000|000000|000000|000000|000000|000000|000000|000000|000000|000000|000000|000000|000000|000000|000000|000000|000000|000000|000000|000000|000000|000000|000000|000000|000000|000000|000000|000000|000000|000000|000000|000000|000000|000000|000000|000000|000000|000000|000000|000000|000000|000000|000000|000000|000000|000000|000000|
000000|000000|000000|000000|000000|000000|000000|000000|000000|000000|000000|000000|000000|000000|000000|000000|000000|000000|000000|000000|000000|000000|000000|000000|000000|000000|000000|000000|000000|000000|000000|000000|000000|000000|000000|000000|000000|000000|000000|000000|000000|000000|000000|000000|000000|000000|000000|000000|000000|000000|
000000|000000|000000|000000|000000|000000|000000|000000|000000|000000|000000|000000|000000|000000|000000|000000|000000|000000|000000|000000|000000|000000|000000|000000|000000|000000|000000|000000|000000|000000|000000|000000|000000|000000|000000|000000|000000|000000|000000|000000|000000|000000|000000|000000|000000|000000|000000|000000|000000|000000|
000000|000000|000000|000000|000000|000000|000000|000000|000000|000000|000000|000000|000000|000000|000000|000000|000000|000000|000000|000000|000000|000000|000000|000000|000000|000000|000000|000000|000000|000000|000000|000000|000000|000000|000000|000000|000000|000000|000000|000000|000000|000000|000000|000000|000000|000000|000000|000000|000000|000000|
000000|000000|000000|000000|000000|000000|000000|000000|000000|000000|000000|000000|000000|000000|000000|000000|000000|000000|000000|000000|000000|000000|000000|000000|000000|000000|000000|000000|000000|000000|000000|000000|000000|000000|000000|000000|000000|000000|000000|000000|000000|000000|000000|000000|000000|000000|000000|000000|000000|000000|
000000|000000|000000|000000|000000|000000|000000|000000|000000|000000|000000|000000|000000|000000|000000|000000|000000|000000|000000|000000|000000|000000|000000|000000|000000|000000|000000|000000|000000|000000|000000|000000|000000|000000|000000|000000|000000|000000|000000|000000|000000|000000|000000|000000|000000|000000|000000|000000|000000|000000|
000000|000000|000000|000000|000000|000000|000000|000000|000000|000000|000000|000000|000000|000000|000000|000000|000000|000000|000000|000000|000000|000000|000000|000000|000000|000000|000000|000000|000000|000000|000000|000000|000000|000000|000000|000000|000000|000000|000000|000000|000000|000000|000000|000000|000000|000000|000000|000000|000000|000000|
000000|000000|000000|000000|000000|000000|000000|000000|000000|000000|000000|000000|000000|000000|000000|000000|000000|000000|000000|000000|000000|000000|000000|000000|000000|000000|000000|000000|000000|000000|000000|000000|000000|000000|000000|000000|000000|000000|000000|000000|000000|000000|000000|000000|000000|000000|000000|000000|000000|000000|
000000|000000|000000|000000|000000|000000|000000|000000|000000|000000|000000|000000|000000|000000|000000|000000|000000|000000|000000|000000|000000|000000|000000|000000|000000|000000|000000|000000|000000|000000|000000|000000|000000|000000|000000|000000|000000|000000|000000|000000|000000|000000|000000|000000|000000|000000|000000|000000|000000|000000|
000000|000000|000000|000000|000000|000000|000000|000000|000000|000000|000000|000000|000000|000000|000000|000000|000000|000000|000000|000000|000000|000000|000000|000000|000000|000000|000000|000000|000000|000000|000000|000000|000000|000000|000000|000000|000000|000000|000000|000000|000000|000000|000000|000000|000000|000000|000000|000000|000000|000000|
000000|000000|000000|000000|000000|000000|000000|000000|000000|000000|000000|000000|000000|000000|000000|000000|000000|000000|000000|000000|000000|000000|000000|000000|000000|000000|000000|000000|000000|000000|000000|000000|000000|000000|000000|000000|000000|000000|000000|000000|000000|000000|000000|000000|000000|000000|000000|000000|000000|000000|
000000|000000|000000|000000|000000|000000|000000|000000|000000|000000|000000|000000|000000|000000|000000|000000|000000|000000|000000|000000|000000|000000|000000|000000|000000|000000|000000|000000|000000|000000|000000|000000|000000|000000|000000|000000|000000|000000|000000|000000|000000|000000|000000|000000|000000|000000|000000|000000|000000|000000|
000000|000000|000000|000000|000000|000000|000000|000000|000000|000000|000000|000000|000000|000000|000000|000000|000000|000000|000000|000000|000000|000000|000000|000000|000000|000000|000000|000000|000000|000000|000000|000000|000000|000000|000000|000000|000000|000000|000000|000000|000000|000000|000000|000000|000000|000000|000000|000000|000000|000000|
000000|000000|000000|000000|000000|000000|000000|000000|000000|000000|000000|000000|000000|000000|000000|000000|000000|000000|000000|000000|000000|000000|000000|000000|000000|000000|000000|000000|000000|000000|000000|000000|000000|000000|000000|000000|000000|000000|000000|000000|000000|000000|000000|000000|000000|000000|000000|000000|000000|000000|
000000|000000|000000|000000|000000|000000|000000|000000|000000|000000|000000|000000|000000|000000|000000|000000|000000|000000|000000|000000|000000|000000|000000|000000|000000|000000|000000|000000|000000|000000|000000|000000|000000|000000|000000|000000|000000|000000|000000|000000|000000|000000|000000|000000|000000|000000|000000|000000|000000|000000|
000000|000000|000000|000000|000000|000000|000000|000000|000000|000000|000000|000000|000000|000000|000000|000000|000000|000000|000000|000000|000000|000000|000000|000000|000000|000000|000000|000000|000000|000000|000000|000000|000000|000000|000000|000000|000000|000000|000000|000000|000000|000000|000000|000000|000000|000000|000000|000000|000000|000000|
000000|000000|000000|000000|000000|000000|000000|000000|000000|000000|000000|000000|000000|000000|000000|000000|000000|000000|000000|000000|000000|000000|000000|000000|000000|000000|000000|000000|000000|000000|000000|000000|000000|000000|000000|000000|000000|000000|000000|000000|000000|000000|000000|000000|000000|000000|000000|000000|000000|000000|
000000|000000|000000|000000|000000|000000|000000|000000|000000|000000|000000|000000|000000|000000|000000|000000|000000|000000|000000|000000|000000|000000|000000|000000|000000|000000|000000|000000|000000|000000|000000|000000|000000|000000|000000|000000|000000|000000|000000|000000|000000|000000|000000|000000|000000|000000|000000|000000|000000|000000|
000000|000000|000000|000000|000000|000000|000000|000000|000000|000000|000000|000000|000000|000000|000000|000000|000000|000000|000000|000000|000000|000000|000000|000000|000000|000000|000000|000000|000000|000000|000000|000000|000000|000000|000000|000000|000000|000000|000000|000000|000000|000000|000000|000000|000000|000000|000000|000000|000000|000000|
000000|000000|000000|000000|000000|000000|000000|000000|000000|000000|000000|000000|000000|000000|000000|000000|000000|000000|000000|000000|000000|000000|000000|000000|000000|000000|000000|000000|000000|000000|000000|000000|000000|000000|000000|000000|000000|000000|000000|000000|000000|000000|000000|000000|000000|000000|000000|000000|000000|000000|
000000|000000|000000|000000|000000|000000|000000|000000|000000|000000|000000|000000|000000|000000|000000|000000|000000|000000|000000|000000|000000|000000|000000|000000|000000|000000|000000|000000|000000|000000|000000|000000|000000|000000|000000|000000|000000|000000|000000|000000|000000|000000|000000|000000|000000|000000|000000|000000|000000|000000|
000000|000000|000000|000000|000000|000000|000000|000000|000000|000000|000000|000000|000000|000000|000000|000000|000000|000000|000000|000000|000000|000000|000000|000000|000000|000000|000000|000000|000000|000000|000000|000000|000000|000000|000000|000000|000000|000000|000000|000000|000000|000000|000000|000000|000000|000000|000000|000000|000000|000000|
000000|000000|000000|000000|000000|000000|000000|000000|000000|000000|000000|000000|000000|000000|000000|000000|000000|000000|000000|000000|000000|000000|000000|000000|000000|000000|000000|000000|000000|000000|000000|000000|000000|000000|000000|000000|000000|000000|000000|000000|000000|000000|000000|000000|000000|000000|000000|000000|000000|000000|
000000|000000|000000|000000|000000|000000|000000|000000|000000|000000|000000|000000|000000|000000|000000|000000|000000|000000|000000|000000|000000|000000|000000|000000|000000|000000|000000|000000|000000|000000|000000|000000|000000|000000|000000|000000|000000|000000|000000|000000|000000|000000|000000|000000|000000|000000|000000|000000|000000|000000|
000000|000000|000000|000000|000000|000000|000000|000000|000000|000000|000000|000000|000000|000000|000000|000000|000000|000000|000000|000000|000000|000000|000000|000000|000000|000000|000000|000000|000000|000000|000000|000000|000000|000000|000000|000000|000000|000000|000000|000000|000000|000000|000000|000000|000000|000000|000000|000000|000000|000000|
000000|000000|000000|000000|000000|000000|000000|000000|000000|000000|000000|000000|000000|000000|000000|000000|000000|000000|000000|000000|000000|000000|000000|000000|000000|000000|000000|000000|000000|000000|000000|000000|000000|000000|000000|000000|000000|000000|000000|000000|000000|000000|000000|000000|000000|000000|000000|000000|000000|000000|
