000000|000000|000000|000000|000000|000000|000000|000000|000000|000000|000000|000000|000000|000000|000000|000000|000000|000000|000000|000000|000000|000000|000000|000000|000000|000000|000000|000000|000000|000000|000000|000000|000000|000000|000000|000000|000000|000000|000000|000000|000000|000000|000000|000000|000000|000000|000000|000000|000000|000000|
000000|010100|010100|010100|000000|010100|010100|010100|000000|010100|010100|010100|010100|010100|010100|010100|000000|000000|000000|000000|000000|000000|000000|000000|000000|000000|000000|000000|000000|000000|000000|000000|000000|000000|000000|000000|000000|000000|000000|000000|000000|000000|000000|000000|000000|000000|000000|000000|000000|000000|
000000|010100|010100|010100|010100|010100|010100|010100|000000|010100|010100|010100|010100|010100|010100|010100|000000|000000|000000|000000|000000|000000|000000|000000|000000|000000|000000|000000|000000|000000|000000|000000|000000|000000|000000|000000|000000|000000|000000|000000|000000|000000|000000|000000|000000|000000|000000|000000|000000|000000|
000000|010100|010100|010100|000000|010100|010100|010100|000000|000000|010100|010100|010100|010100|010100|000000|000000|000000|000000|000000|000000|000000|000000|000000|000000|000000|000000|000000|000000|000000|000000|000000|000000|000000|000000|000000|000000|000000|000000|000000|000000|000000|000000|000000|000000|000000|000000|000000|000000|000000|
000000|000000|010100|000000|000000|000000|010100|000000|000000|000000|000000|010100|010100|010100|000000|000000|000000|000000|000000|000000|000000|000000|000000|000000|000000|000000|000000|000000|000000|000000|000000|000000|000000|000000|000000|000000|000000|000000|000000|000000|000000|000000|000000|000000|000000|000000|000000|000000|000000|000000|
000000|010100|010100|010100|000000|010100|010100|010100|000000|000000|000000|000000|010100|000000|000000|000000|000000|000000|000000|000000|000000|000000|000000|000000|000000|000000|000000|000000|000000|000000|000000|000000|000000|000000|000000|000000|000000|000000|000000|000000|000000|000000|000000|000000|000000|000000|000000|000000|000000|000000|
000000|010100|010100|010100|000000|010100|010100|010100|000000|010100|010100|010100|010100|010100|020201|010100|010100|010100|010100|000000|010100|010100|010100|000000|010100|010100|010100|000000|000000|000000|000000|000000|000000|000000|000000|000000|000000|000000|000000|000000|000000|000000|000000|000000|000000|000000|000000|000000|000000|000000|
000000|010100|010100|010100|010100|010100|010100|010100|010100|010100|010100|010100|010100|010100|020201|010100|010100|010100|010100|010100|010100|010100|010100|010100|010100|010100|010100|000000|000000|000000|000000|000000|000000|000000|000000|000000|000000|000000|000000|000000|000000|000000|000000|000000|000000|000000|000000|000000|000000|000000|
000000|010100|010100|010100|000000|010100|010100|010100|000000|010100|010100|010100|010100|010100|020201|010100|010100|010100|010100|000000|010100|010100|010100|000000|010100|010100|010100|000000|000000|000000|000000|000000|000000|000000|000000|000000|000000|000000|000000|000000|000000|000000|000000|000000|000000|000000|000000|000000|000000|000000|
000000|000000|010100|000000|000000|000000|000000|000000|000000|000000|000000|000000|010100|000000|000000|000000|000000|000000|000000|000000|000000|000000|000000|000000|000000|000000|000000|000000|000000|000000|000000|000000|000000|000000|000000|000000|000000|000000|000000|000000|000000|000000|000000|000000|000000|000000|000000|000000|000000|000000|
000000|010100|010100|010100|000000|000000|000000|000000|000000|000000|000000|010100|010100|010100|000000|000000|000000|000000|000000|000000|000000|000000|000000|000000|000000|000000|000000|000000|000000|000000|000000|000000|000000|000000|000000|000000|000000|000000|000000|000000|000000|000000|000000|000000|000000|000000|000000|000000|000000|000000|
000000|010100|010100|010100|020201|020201|020201|020201|020201|020201|020201|010100|010100|010100|000000|000000|000000|000000|000000|000000|000000|000000|000000|000000|000000|000000|000000|000000|000000|000000|000000|000000|000000|000000|000000|000000|000000|000000|000000|000000|000000|000000|000000|000000|000000|000000|000000|000000|000000|000000|
000000|010100|010100|010100|000000|000000|000000|000000|000000|000000|000000|010100|010100|010100|000000|000000|000000|000000|000000|000000|000000|000000|000000|000000|000000|000000|000000|000000|000000|000000|000000|000000|000000|000000|000000|000000|000000|000000|000000|000000|000000|000000|000000|000000|000000|000000|000000|000000|000000|000000|
000000|000000|000000|000000|000000|000000|000000|000000|000000|000000|000000|000000|000000|000000|000000|000000|000000|000000|000000|000000|000000|000000|000000|000000|000000|000000|000000|000000|000000|000000|000000|000000|000000|000000|000000|000000|000000|000000|000000|000000|000000|000000|000000|000000|000000|000000|000000|000000|000000|000000|
000000|000000|000000|000000|000000|000000|000000|000000|000000|000000|000000|000000|000000|000000|000000|000000|000000|000000|000000|000000|000000|000000|000000|000000|000000|000000|000000|000000|000000|000000|000000|000000|000000|000000|000000|000000|000000|000000|000000|000000|000000|000000|000000|000000|000000|000000|000000|000000|000000|000000|
000000|000000|000000|000000|000000|000000|000000|000000|000000|000000|000000|000000|000000|000000|000000|000000|000000|000000|000000|000000|000000|000000|000000|000000|000000|000000|000000|000000|000000|000000|000000|000000|000000|000000|000000|000000|000000|000000|000000|000000|000000|000000|000000|000000|000000|000000|000000|000000|000000|000000|
000000|000000|000000|000000|000000|000000|000000|000000|000000|000000|000000|000000|000000|000000|000000|000000|000000|000000|000000|000000|000000|000000|000000|000000|000000|000000|000000|000000|000000|000000|000000|000000|000000|000000|000000|000000|000000|000000|000000|000000|000000|000000|000000|000000|000000|000000|000000|000000|000000|000000|
000000|000000|000000|000000|000000|000000|000000|000000|000000|000000|000000|000000|000000|000000|000000|000000|000000|000000|000000|000000|000000|000000|000000|000000|000000|000000|000000|000000|000000|000000|000000|000000|000000|000000|000000|000000|000000|000000|000000|000000|000000|000000|000000|000000|000000|000000|000000|000000|000000|000000|
000000|000000|000000|000000|000000|000000|000000|000000|000000|000000|000000|000000|000000|000000|000000|000000|000000|000000|000000|000000|000000|000000|000000|000000|000000|000000|000000|000000|000000|000000|000000|000000|000000|000000|000000|000000|000000|000000|000000|000000|000000|000000|000000|000000|000000|000000|000000|000000|000000|000000|
000000|000000|000000|000000|000000|000000|000000|000000|000000|000000|000000|000000|000000|000000|000000|000000|000000|000000|000000|000000|000000|000000|000000|000000|000000|000000|000000|000000|000000|000000|000000|000000|000000|000000|000000|000000|000000|000000|000000|000000|000000|000000|000000|000000|000000|000000|000000|000000|000000|000000|
000000|000000|000000|000000|000000|000000|000000|000000|000000|000000|000000|000000|000000|000000|000000|000000|000000|000000|000000|000000|000000|000000|000000|000000|000000|000000|000000|000000|000000|000000|000000|000000|000000|000000|000000|000000|000000|000000|000000|000000|000000|000000|000000|000000|000000|000000|000000|000000|000000|000000|
000000|000000|000000|000000|000000|000000|000000|000000|000000|000000|000000|000000|000000|000000|000000|000000|000000|000000|000000|000000|000000|000000|000000|000000|000000|000000|000000|000000|000000|000000|000000|000000|000000|000000|000000|000000|000000|000000|000000|000000|000000|000000|000000|000000|000000|000000|000000|000000|000000|000000|
000000|000000|000000|000000|000000|000000|000000|000000|000000|000000|000000|000000|000000|000000|000000|000000|000000|000000|000000|000000|000000|000000|000000|000000|000000|000000|000000|000000|000000|000000|000000|000000|000000|000000|000000|000000|000000|000000|000000|000000|000000|000000|000000|000000|000000|000000|000000|000000|000000|000000|
000000|000000|000000|000000|000000|000000|000000|000000|000000|000000|000000|000000|000000|000000|000000|000000|000000|000000|000000|000000|000000|000000|000000|000000|000000|000000|000000|000000|000000|000000|000000|000000|000000|000000|000000|000000|000000|000000|000000|000000|000000|000000|000000|000000|000000|000000|000000|000000|000000|000000|
000000|000000|000000|000000|000000|000000|000000|000000|000000|000000|000000|000000|000000|000000|000000|000000|000000|000000|000000|000000|000000|000000|000000|000000|000000|000000|000000|000000|000000|000000|000000|000000|000000|000000|000000|000000|000000|000000|000000|000000|000000|000000|000000|000000|000000|000000|000000|000000|000000|000000|
000000|000000|000000|000000|000000|000000|000000|000000|000000|000000|000000|000000|000000|000000|000000|000000|000000|000000|000000|000000|000000|000000|000000|000000|000000|000000|000000|000000|000000|000000|000000|000000|000000|000000|000000|000000|000000|000000|000000|000000|000000|000000|000000|000000|000000|000000|000000|000000|000000|000000|
000000|000000|000000|000000|000000|000000|000000|000000|000000|000000|000000|000000|000000|000000|000000|000000|000000|000000|000000|000000|000000|000000|000000|000000|000000|000000|000000|000000|000000|000000|000000|000000|000000|000000|000000|000000|000000|000000|000000|000000|000000|000000|000000|000000|000000|000000|000000|000000|000000|000000|
000000|000000|000000|000000|000000|000000|000000|000000|000000|000000|000000|000000|000000|000000|000000|000000|000000|000000|000000|000000|000000|000000|000000|000000|000000|000000|000000|000000|000000|000000|000000|000000|000000|000000|000000|000000|000000|000000|000000|000000|000000|000000|000000|000000|000000|000000|000000|000000|000000|000000|
000000|000000|000000|000000|000000|000000|000000|000000|000000|000000|000000|000000|000000|000000|000000|000000|000000|000000|000000|000000|000000|000000|000000|000000|000000|000000|000000|000000|000000|000000|000000|000000|000000|000000|000000|000000|000000|000000|000000|000000|000000|000000|000000|000000|000000|000000|000000|000000|000000|000000|
000000|000000|000000|000000|000000|000000|000000|000000|000000|000000|000000|000000|000000|000000|000000|000000|000000|000000|000000|000000|000000|000000|000000|000000|000000|000000|000000|000000|000000|000000|000000|000000|000000|000000|000000|000000|000000|000000|000000|000000|000000|000000|000000|000000|000000|000000|000000|000000|000000|000000|
000000|000000|000000|000000|000000|000000|000000|000000|000000|000000|000000|000000|000000|000000|000000|000000|000000|000000|000000|000000|000000|000000|000000|000000|000000|000000|000000|000000|000000|000000|000000|000000|000000|000000|000000|000000|000000|000000|000000|000000|000000|000000|000000|000000|000000|000000|000000|000000|000000|000000|
000000|000000|000000|000000|000000|000000|000000|000000|000000|000000|000000|000000|000000|000000|000000|000000|000000|000000|000000|000000|000000|000000|000000|000000|000000|000000|000000|000000|000000|000000|000000|000000|000000|000000|000000|000000|000000|000000|000000|000000|000000|000000|000000|000000|000000|000000|000000|000000|000000|000000|
000000|000000|000000|000000|000000|000000|000000|000000|000000|000000|000000|000000|000000|000000|000000|000000|000000|000000|000000|000000|000000|000000|000000|000000|000000|000000|000000|000000|000000|000000|000000|000000|000000|000000|000000|000000|000000|000000|000000|000000|000000|000000|000000|000000|000000|000000|000000|000000|000000|000000|
000000|000000|000000|000000|000000|000000|000000|000000|000000|000000|000000|000000|000000|000000|000000|000000|000000|000000|000000|000000|000000|000000|000000|000000|000000|000000|000000|000000|000000|000000|000000|000000|000000|000000|000000|000000|000000|000000|000000|000000|000000|000000|000000|000000|000000|000000|000000|000000|000000|000000|
000000|000000|000000|000000|000000|000000|000000|000000|000000|000000|000000|000000|000000|000000|000000|000000|000000|000000|000000|000000|000000|000000|000000|000000|000000|000000|000000|000000|000000|000000|000000|000000|000000|000000|000000|000000|000000|000000|000000|000000|000000|000000|000000|000000|000000|000000|000000|000000|000000|000000|
000000|000000|000000|000000|000000|000000|000000|000000|000000|000000|000000|000000|000000|000000|000000|000000|000000|000000|000000|000000|000000|000000|000000|000000|000000|000000|000000|000000|000000|000000|000000|000000|000000|000000|000000|000000|000000|000000|000000|000000|000000|000000|000000|000000|000000|000000|000000|000000|000000|000000|
000000|000000|000000|000000|000000|000000|000000|000000|000000|000000|000000|000000|000000|000000|000000|000000|000000|000000|000000|000000|000000|000000|000000|000000|000000|000000|000000|000000|000000|000000|000000|000000|000000|000000|000000|000000|000000|000000|000000|000000|000000|000000|000000|000000|000000|000000|000000|000000|000000|000000|
000000|000000|000000|000000|000000|000000|000000|000000|000000|000000|000000|000000|000000|000000|000000|000000|000000|000000|000000|000000|000000|000000|000000|000000|000000|000000|000000|000000|000000|000000|000000|000000|000000|000000|000000|000000|000000|000000|000000|000000|000000|000000|000000|000000|000000|000000|000000|000000|000000|000000|
000000|000000|000000|000000|000000|000000|000000|000000|000000|000000|000000|000000|000000|000000|000000|000000|000000|000000|000000|000000|000000|000000|000000|000000|000000|000000|000000|000000|000000|000000|000000|000000|000000|000000|000000|000000|000000|000000|000000|000000|000000|000000|000000|000000|000000|000000|000000|000000|000000|000000|
000000|000000|000000|000000|000000|000000|000000|000000|000000|000000|000000|000000|000000|000000|000000|000000|000000|000000|000000|000000|000000|000000|000000|000000|000000|000000|000000|000000|000000|000000|000000|000000|000000|000000|000000|000000|000000|000000|000000|000000|000000|000000|000000|000000|000000|000000|000000|000000|000000|000000|
000000|000000|000000|000000|000000|000000|000000|000000|000000|000000|000000|000000|000000|000000|000000|000000|000000|000000|000000|000000|000000|000000|000000|000000|000000|000000|000000|000000|000000|000000|000000|000000|000000|000000|000000|000000|000000|000000|000000|000000|000000|000000|000000|000000|000000|000000|000000|000000|000000|000000|
000000|000000|000000|000000|000000|000000|000000|000000|000000|000000|000000|000000|000000|000000|000000|000000|000000|000000|000000|000000|000000|000000|000000|000000|000000|000000|000000|000000|000000|000000|000000|000000|000000|000000|000000|000000|000000|000000|000000|000000|000000|000000|000000|000000|000000|000000|000000|000000|000000|000000|
000000|000000|000000|000000|000000|000000|000000|000000|000000|000000|000000|000000|000000|000000|000000|000000|000000|000000|000000|000000|000000|000000|000000|000000|000000|000000|000000|000000|000000|000000|000000|000000|000000|000000|000000|000000|000000|000000|000000|000000|000000|000000|000000|000000|000000|000000|000000|000000|000000|000000|
000000|000000|000000|000000|000000|000000|000000|000000|000000|000000|000000|000000|000000|000000|000000|000000|000000|000000|000000|000000|000000|000000|000000|000000|000000|000000|000000|000000|000000|000000|000000|000000|000000|000000|000000|000000|000000|000000|000000|000000|000000|000000|000000|000000|000000|000000|000000|000000|000000|000000|
000000|000000|000000|000000|000000|000000|000000|000000|000000|000000|000000|000000|000000|000000|000000|000000|000000|000000|000000|000000|000000|000000|000000|000000|000000|000000|000000|000000|000000|000000|000000|000000|000000|000000|000000|000000|000000|000000|000000|000000|000000|000000|000000|000000|000000|000000|000000|000000|000000|000000|
000000|000000|000000|000000|000000|000000|000000|000000|000000|000000|000000|000000|000000|000000|000000|000000|000000|000000|000000|000000|000000|000000|000000|000000|000000|000000|000000|000000|000000|000000|000000|000000|000000|000000|000000|000000|000000|000000|000000|000000|000000|000000|000000|000000|000000|000000|000000|000000|000000|000000|
000000|000000|000000|000000|000000|000000|000000|000000|000000|000000|000000|000000|000000|000000|000000|000000|000000|000000|000000|000000|000000|000000|000000|000000|000000|000000|000000|000000|000000|000000|000000|000000|000000|000000|000000|000000|000000|000000|000000|000000|000000|000000|000000|000000|000000|000000|000000|000000|000000|000000|
000000|000000|000000|000000|000000|000000|000000|000000|000000|000000|000000|000000|000000|000000|000000|000000|000000|000000|000000|000000|000000|000000|000000|000000|000000|000000|000000|000000|000000|000000|000000|000000|000000|000000|000000|000000|000000|000000|000000|000000|000000|000000|000000|000000|000000|000000|000000|000000|000000|000000|
000000|000000|000000|000000|000000|000000|000000|000000|000000|000000|000000|000000|000000|000000|000000|000000|000000|000000|000000|000000|000000|000000|000000|000000|000000|000000|000000|000000|000000|000000|000000|000000|000000|000000|000000|000000|000000|000000|000000|000000|000000|000000|000000|000000|000000|000000|000000|000000|000000|000000|
000000|000000|000000|000000|000000|000000|000000|000000|000000|000000|000000|000000|000000|000000|000000|000000|000000|000000|000000|000000|000000|000000|000000|000000|000000|000000|000000|000000|000000|000000|000000|000000|000000|000000|000000|000000|000000|000000|000000|000000|000000|000000|000000|000000|000000|000000|000000|000000|000000|000000|
